灿荣	Jackey
蔡牧师	Andrew
柏万	William
悦茜	茜茜
耀宏	不倒翁
宗尉	Zhongwei
卢伟	Luka
自超	李自超
成禾	王成禾
昀晏	Yun-Yen
明亮	美意的小熊糖
以恒	sweet
若涵	若涵
泰禾	泰禾
文佳	佳佳
君昊	Danny
明星	humingxing
董婷	Ting
李志	小中
卓阳	可惜我是刘卓阳
兴伟	佚小凡
佳宁	QQQJN
靖珊	BergBerg
晨醒	醒醒
燕杉	Y
郑凯	郑能量
岩美	Nancy
刘欢	我心飞扬
志钰	志钰
元鹏	YuanPeng
蔡师母	阿玲
裙子	群子在德国
